NO ./textures/north.xpm
SO ./textures/south.xpm
WE ./textures/west.xpm
EA ./textures/east.xpm
F 255,255,255
C 0,0,0

1111111
1N0A001
1000001
1111111