NO ./textures/north.xpm
SO ./textures/south.xpm
WE ./textures/west.xpm
EA ./textures/east.xpm
F 200,200,200
C 100,100,100

1111111111
1000000001
1000111001
1000000001
1111111111