NO ./textures/north.xpm
SO ./textures/south.xpm
WE ./textures/west.xpm
EA ./textures/east.xpm
F 100,150,200
C 255,255,255

111111111111
100000000001
100000000001
10000 000001
100000000001
1000N0000001
111111111111