NO ./textures/north.xpm
SO ./textures/south.xpm
WE ./textures/west.xpm
EA ./textures/east.xpm
F 220,220,220
C 128,128,128

11111111
1N000001
10000001
11111111
00000000